0222222222220
1021020210210
3102020202112
3210011001032
1021111110210
1020300120210
1222233222230
1300000000130
