0222222222220
1022002002210
3020302120212
3201020210032
1030100101210
1103011012110
1222322322230
1300000000130
